████████████████████████████████████████████████████████████████████████████████████████████████████████████████████████████████████████████████████████████████████████████████████████████████████████████████████████████████████████████████████████████████████████████████████████████████████████████████████████████████████████████████████████████████████████████████████████████
█                                                                                                                                                                                                                                                                                                                                                                                          █
█                                                                                                                                                                                                                                                                                                                                                                                          █
█                                                                                                                                                                                                                                                                                                                                                                                          █
█                                                                                                                                                                                                                                                                                                                                                                                          █
█                                                                                                                                                                                                                                                                                                                                                                                          █
█                                                                                                                                                                                                                          #                                                                                                                                       #    X                  █
█                                                                                                                                                                                                                          #████████████████████████████████████████                                                                                               #█████████              █
█                                                                                                                                                                                                                          #█                                                                                                                                      #                       █
█                                                                                                                                                                                                                          #█                                                                                                                                      #                       █
█                                                                                                                                                                                                                          #█                                                                                                                                      #                       █
█                                                                                                                                                                                                                          #█                                                                                                                                      #                       █
█                                                                                                                                                                                                                          #█                                                                                         ████████████████████                         #                       █
█                                                                                                                                                                                                                          #█                                                                                                                                      #                       █
█                                                                                                                                                                                                                          #█                                                                                                                                      #                       █
█                                                                                                                                                                                                                          #█                                                                                                                                      #                       █
█                                                                                                                                                                                                                          #█                                                                                                                                      #                       █
█                                                                                                                                                                                                                          #█                                                 ████████████████████                                                                 #                       █
█                                                                                                                                                                                                                          #█                                                                                                                                      #                       █
█                                                                                                                                                                                                                          #█                                                                                                                                      #                       █
█                                                                                                                                                                                                                          #█                                                                                                                                      #                       █
█                                                                                                                                                                                                                          #█                                                                                                                                      #                       █
█                                                                                                                                                                                                                          #█                                                                                                                                      #                       █
█                                                                                                                                                                                                                          #█                                                                                                                                      #                       █
█                                                                               #                                                                §                                                                         #█                                                                                                                                      #                       █
█                                                                               #█████████████████████████████████████████████████████████████████████                                                                     #█                                                                                                                                      #                       █
█                                                                               #                                                                                                                                          #█                                                                                                                                      #                       █
█                                                                               #                                                                                                                                          #█                                                                                                                                      #                       █
█                                                                               #                                                                                                                                          #█                                                                                                                                      #                       █
█                                                                               #                                                                                                                                          #█                                                                                                                                      #                       █
█                                                                               #                                                                                                                                          #█                                                                                                                                      #                       █
█                                                                               #                                                                                                                                          #█                                                                                                                                      #                       █
█                                                                               #                                                                                                                                          #█                                                                                                                                      #                       █
█                                                                               #                                                                                                                                          #█                                                                                                                                      #                       █
█                                                                               #                                                                                                                                          #█                                                                                                                                      #                       █
█                   ██████████████████████████████                              #                                                                                                                                          #█                                                                                                                                      #                       █
█                                                                               #                                                                                                                                          #█                                                                                                                                      #                       █
█                                                                               #                                                                                                                                          #█                                                                                                                                      #                       █
█    @                   ▲▲▲▲▲▲▲▲▲▲▲▲▲▲▲▲▲▲▲▲                                   #                                                                     ▲▲▲▲▲▲▲▲▲▲▲▲▲▲▲▲▲▲▲▲▲▲                                               #█                                                                                                                                      #                       █
████████████████████████████████████████████████████████████████████████████████████████████████████████████████████████████████████████████████████████████████████████████████████████████████████████████████████████████████████████████████████████████████████████████████████████████████████████████████████████████████████████████████████████████████████████████████████████████
