. . . . . . . . . . . . . . . . . . . . . . . . . . . . . . . . . . . . . . . . . . . . . . . . . . . . . . . . . . . . . . . . . . . . . . . . . . . . . . . . . . . . . . . . . . . . . . . . . . . . . . . . . . . . . . . . . . . . . . . . . .
                                                                                                                                                                                                                                                   
                                                                                                                                                                                                                                                   
                                                                                                                                                                                                                                                   
                               █                                                         █                                                                                                                                                         
█                             ██                                                         █                                                                                   █                                        █                            
█                            ███                                                         █                                                                                  █                                          █                           
█                           ████                                                         █                                                                                 █                                            █                          
█                          █████                                                         █                                                                                █                                              █                         
███████████████████████████████████████████████████████████████████████████████████████████████████████████████████████████████████████████████████████████████████████████████████████████████████████████████████████████████████████████████████
███████████████████████████████████████████████████████████████████████████████████████████████████████████████████████████████████████████████████████████████████████████████████████████████████████████████████████████████████████████████████
