
. . . . . . . . . . . . . . . . . . . . . . . . . . . . . . . . . . . . . . . . . . . . . . . . . . . . . . . . . . . . . . . . . . . . . . . . . . . . . . . . . . . . . .

█                                                                                                                           █
█                                                                                                                           █
█                                                                                                                           █
█                                   █████                                                                                   █
█                                                                                                                           █
█                         ███                                                                                               █
█                                                                                                                           █
█               ███████                                                                                                     █
█                                                                                             ████                          █
█                                                                                                                           █
█                                         █████████                                                                         █
█                                                                                                                           █
█           ███                                                                                                             █
█                                                                                                                           █
█                                                                                                                           █
█                               ███                           █████                                                         █
█                              ████                           █████                                                         █
█                             █████                           █████                                   ███                   █
█                            ██████                           █████                                  ████                  █
█                           ███████                           █████                                 █████                  █
██████████████████████████████████████████████████████████████████████████████████████████████████████████████████████████████
██████████████████████████████████████████████████████████████████████████████████████████████████████████████████████████████
